carbohidratos	k a rf b o i D rf a t o s
presente	p rf e s e n t e
cabaret	k a b a rf e t
revés	r e b e+ s
unigenitos	u n i x e n i t o s
vector	b e k t o rf
lanas	l a n a s
hervir	e rf b i rf
vanidad	b a n i D a
véctor	b e+ k t o rf
servidumbre	s e rf b i D u m b rf e
las	l a s
intervención	i n t e rf b e ng s j o+ ng
vez	b e s
valuación	b a l w a T j o+ n
pulverizar	p u l b e rf i T a rf
derbi	d e rf b i
bajeza	b a x e T a
hablas	a b l a s
palsero	p a l s e rf o
vacaciones	b a k a T j o n e s
cien	s j e ng
circonio	s i rf k o n j o
zona	T o n a
útil	u+ t i l
velatorio	b e l a t o rf j o
carbono	k a rf b o n o
benigno	b e n i G n o
base	b a s e
charcos	tS a rf k o s
tos	t o s
hoy	oI
aquí	a k i+
abánicos	a b a+ n i k o s
acabar	a k a b a rf
hotel	o t e l
lujo	l u x o
valle	b a L e
payaso	p aI a s o
hechas	e tS a s
brillante	b rf i L a n t e
baile	b aI l e
asado	a s a o
casual	k a s w a l
causal	k aU s a l
general	x e n e rf a l
trabajas	t rf a b a x a s
básico	b a+ s i k o
baliza	b a l i s a
nuestros	n w e s t rf o s
control	k o n t rf o l
fosil	f o s i l
socavar	s o k a b a rf
amarillas	a m a rf i L a s
bisco	b i s k o
zepelín	s e p e l i+ ng
afuera	a f w e rf a
nivel	n i b e l
brócoli	b rf o+ k o l i
polvo	p o l b o
libro	l i b rf o
nuestro	n w e s t rf o
comerás	k o m e rf a+ s
cero	s e rf o
abastecer	a b a s t e s e rf
alto	a l t o
lobo	l o b o
paqueta	p a k e t a
ubicaciones	u b i k a T j o n e s
ancho	a n tS o
barómetro	b a rf o+ m e t rf o
tareas	t a rf e a s
convoy	k o m V oI
liso	l i s o
unigénitos	u n i x e+ n i t o s
válido	b a+ l i D o
zorro	T o r o
valor	b a l o rf
zanahoria	s a n a o rf j a
tus	t u s
vandalismo	b a n d a l i z m o
cajas	k a x a s
servicio	s e rf b i s j o
abanicos	a b a n i k o s
porvenir	p o rf b e n i rf
lotería	l o t e rf i+ a
boca	b o k a
ves	b e s
enanitos	e n a n i t o s
vaca	b a k a
hambriento	a m b rf j e n t o
árbol	a+ rf b o l
azul	a T u l
olvidados	o l b i D a D o s
literatura	l i t e rf a t u rf a
limpio	l i m p j o
bien	b j e ng
ceja	s e x a
lunes	l u n e s
longitud	l o n x i t u
barometro	b a rf o m e t rf o
excavador	e k s k a b a D o rf
balcón	b a l k o+ ng
valija	b a l i x a
abandonar	a b a n d o n a rf
prosa	p rf o s a
balada	b a l a D a
límite	l i+ m i t e
televisión	t e l e b i s j o+ ng
obreros	o b rf e rf o s
ailas	aI l a s
lógica	l o+ x i k a
escavador	e s k a b a D o rf
bóa	b o+ a
amargas	a m a rf G a s
pesero	p e s e rf o
música	m u+ s i k a
apio	a p j o
alboroto	a l b o rf o t o
convalecer	k o ng V a l e s e rf
albino	a l b i n o
ventaja	b e n t a x a
revista	r e b i s t a
encadenado	e ng k a D e n a D o
jueves	x w e b e s
vacante	b a k a n t e
bacterias	b a k t e rf j a s
naranjas	n a rf a ng x a s
alba	a l b a
vapor	b a p o rf
balsámico	b a l s a+ m i k o
vaso	b a s o
lucha	l u tS a
fósil	f o+ s i l
zoológico	T o o l o+ x i k o
pisco	p i s k o
zigoto	s i G o t o
a	a
vaqueta	b a k e t a
zombi	T o m b i
vaciar	b a s j a rf
cebolla	s e b o L a
valiza	b a l i s a
galvano	G a l b a n o
socovar	s o k o b a rf
hiperbólico	i p e rf b o+ l i k o
salvación	s a l b a s j o+ ng
banda	b a n d a
vaya	b a L a
piel	p j e l
vainilla	b aI n i L a
dios	d j o s
vecino	b e s i n o
basura	b a s u rf a
abónicos	a b o+ n i k o s
balsero	b a l s e rf o
bochornoso	b o tS o rf n o s o
vagoneta	b a G o n e t a
los	l o s
vaquera	b a k e rf a
águilas	a+ g i l a s
balcero	b a l T e rf o
nuestras	n w e s t rf a s
aguilas	a g i l a s
anchas	a n tS a s
bajo	b a x o
líquido	l i+ k i D o
señal	s e n~ a l
amigas	a m i G a s
marbete	m a rf b e t e
bigote	b i G o t e
cintura	T i n t u rf a
vacío	b a s i+ o
vampiro	b a m p i rf o
terminarás	t e rf m i n a rf a+ s
arbusto	a rf b u s t o
